afaik as far as i know
afk	away from keyboard
atw	all the way
bb be back
bbl	be back later
bbs	be back soon
bc because
bf	boyfriend
bff	best friend forever
brb	be right back
btw	by the way
cba	cant be arsed
convo conversation
cp	child porn
cya	see you
e2e	end-to-end
fml	fuck my life
fomo fear of missing out
ftfy fixed that for you
ftl	for the lose
ftw	for the win
fwiw for what its worth
fyi	for your information
g2g	got to go
g4u	good for you
gf	girlfriend
goml get on my level
gr8	great
gratz congratulations
gtfo get the fuck out
hbu	how about you
hru	how are you
idc	i dont care
idgaf i dont give a fuck
idk	i dont  know
iirc if i recall correctly
ik	i know
ikr	i know right
ily	i love you
inb4 in before
irl	in real life
jfc	jesus fucking christ
jk	just kidding
k ok
l8r	later
leet elite
m8 mate
maga make america great again
mfw	my feeling when
mrw	my reaction when
ngl	not gonna lie
nm	not much
nmu	not much you
nvm	never mind
ofc	of course
omf	oh my fuck
omg	oh my god
omw	on my way
ooc	out of context
orly oh really
plz	please
pron porn
rly	really
rtfm read the fucking manual
smd	suck my dick
smh	shake my head
soz	sorry
tbf	to be fair
tbh	to be honest
tbt	throwback to
tifu today i fucked up
tf the fuck
tfw	that feeling when
thx	thanks
tldr	too long didnt read
tmw	that moment when
ty	thank you
wtf	what the fuck
yarly yeah really
yolo you only live once
yw youre welcome
